7 7
BBBBB#A
#######
##MB##B
###B###
###B###
####M##
BBB####

##A##A#
##B##M#
##B####
B#B#BB#
##B####
##B#BB#
M######
